#####################################################
#################### C    ###########################
####################      ###########################
#############                S#######################
#############                 #######################
##########                        ###################
##########                        ###################
##########                        ###################
##########         ###               C ##############
##########         ###    ###          ##############
##########         ###    ###          ##############
########                  ###          ##############
########     ###                       ##############
########     ###                       ##############
########                               ##############
########P                              ##############
#############               ##         ##############
#####################################################
#####################################################